{
    "tiles": [
        "                                ",
        "                                ",
        "                                ",
        "               1111111          ",
        "        1111111111              ",
        "         1111                   ",
        "        1111       11           ",
        "       111       13331          ",
        "       1        13331           ",
        "       111     1111111          ",
        "  2     1111  111               ",
        "              11                ",
        "  22 2         1111     22      ",
        " 222          111    222        ",
        "   22      1111     2222 22     ",
        "      11 11111        222       ",
        "     11113333111          2     ",
        "      1113331111111     2       ",
        "        1111111111        2     ",
        "            1111                ",
        "       11111111                 ",
        "        11111111                ",
        "             1111               ",
        "                1111            ",
        "              1111 1111         ",
        "                1111            ",
        "                                ",
        "          1111                  ",
        "        111111                  ",
        "         1111                   ",
        "          1                     ",
        "                                "
    ],
    "units": [
        
    ]
}
